Color	KEYWORD1
Point	KEYWORD1
SerialScreen	KEYWORD1

open	KEYWORD2
close	KEYWORD2
isOpen	KEYWORD2
setScreen	KEYWORD2
clearScreen	KEYWORD2
setColor	KEYWORD2
drawLine	KEYWORD2
drawRectangle	KEYWORD2
fillRectangle	KEYWORD2
drawPolygon	KEYWORD2
fillPolygon	KEYWORD2
drawCircle	KEYWORD2
fillCircle	KEYWORD2
drawPie	KEYWORD2
fillPie	KEYWORD2
setFont	KEYWORD2
drawString	KEYWORD2
drawImage	KEYWORD2
loadImage	KEYWORD2

BLACK	LITERAL1
RED	LITERAL1
GREEN	LITERAL1
BLUE	LITERAL1
YELLOW	LITERAL1
CYAN	LITERAL1
MAGENTA	LITERAL1
WHITE	LITERAL1
GRAY	LITERAL1
